#############################
#          u   u   u        #
#                           #
# P                         #
#    ^                      #
#MMMM#-----#####---##########
######                  #
.....#                E #
.....#     #####^^^######
.....#     #...#####
.....# C   #
.....#######