#########################
#                       #
#                       #
#                       #
#                 P     #
#  C                  E #
###########^^^^^#########
..........#######