....##################################
....#                                #
....#                                #
#####                                S
#   u      #####  P  #####           #
#     C    #...#     #...#  M        #
#   ########...#######...#######^^^^^#
#   #..........................#######
# E #
#####