########################
#                      #
#                      #
#                      #
#                  E   #
#               ########
#            P  #
#               #
#          ######
#    C     #
#^^^^#######
######