..##########################################
..#                  uuu                   #
###                                        #
#                 #########                #
# P               #.......#                #
#C          #######.......#                #
#           #  #  #.......#        M       #
###################.......#        M       #
..........................#        M       #
...........#########################       #
...........#                               #
...........#                               #
...........#                               #
...........# E                             #
...........########^^^^^^^^^^###############
..................############