..#######################################
..#                                     #
###                                     #
#                 #########             #
# P               #.......#             #
#                 #.......#             #
#############^^^^^#.......#             #
............#######.......#             #
..........................#             #
..........................#             #
..........................#             #
..........................#             #
..........................#             #
..........................#             #
..........................#^^############
..........................####