..#######################################
..#                  uuu                #
###                                     #
#                 #########             #
# P               #.......#             #
#C          #######.......#             #
#           #  #  #.......#             #
###################.......#             #
..........................#             #
...........######################       #
...........#                            #
...........#                            #
...........#                            #
...........# E                          #
...........########^^^^^^^^^^############
..................############