..#######################################
..#                                     #
###                                     #
#                 #########             #
# P               #.......#             #
#                 #.......#             #
###################.......#             #
..........................#             #
..........................#             #
..........................#             #
..........................#             #
..........................#             #
..........................#             #
..........................#             #
..........................###############