..#######################################
..#                                     #
###                                     #
#                 #########             #
# P               #.......#             #
#C          #######.......#             #
#           #  #  #.......#             #
###################.......#             #
..........................#             #
..........................#######       #
..........................#             #
..........................#             #
..........................#             #
..........................#             #
..........................#^^############
..........................####